//MAP CONVERTED BY dmm2tgm.py THIS HEADER COMMENT PREVENTS RECONVERSION, DO NOT REMOVE
"ay" = (
/obj/structure/table/wood/bar{
	boot_dir = 8
	},
/obj/effect/turf_decal/tile/bar{
	dir = 1
	},
/obj/item/storage/box/mre,
/obj/machinery/door/firedoor/border_only{
	dir = 4
	},
/turf/open/floor/plasteel,
/area/shuttle/escape)
"aF" = (
/obj/machinery/door/window/eastleft{
	name = "bar counter door"
	},
/obj/effect/turf_decal/tile/bar{
	dir = 1
	},
/obj/effect/turf_decal/tile/bar,
/obj/machinery/door/firedoor/border_only{
	dir = 4
	},
/turf/open/floor/plasteel,
/area/shuttle/escape)
"aZ" = (
/obj/machinery/defibrillator_mount/loaded{
	pixel_x = -28;
	pixel_y = -3
	},
/turf/open/floor/mineral/titanium/white,
/area/shuttle/escape)
"bu" = (
/obj/structure/table,
/obj/item/gps{
	gpstag = "RECOV"
	},
/turf/open/floor/mineral/titanium/blue,
/area/shuttle/escape)
"bP" = (
/obj/structure/window/reinforced{
	dir = 4
	},
/obj/machinery/door/firedoor/border_only,
/turf/open/floor/mineral/titanium,
/area/shuttle/escape)
"cN" = (
/obj/machinery/chem_dispenser/drinks/beer/fullupgrade{
	dir = 4
	},
/obj/effect/turf_decal/tile/bar{
	dir = 1
	},
/obj/effect/turf_decal/tile/bar,
/obj/structure/table,
/obj/machinery/light{
	dir = 8
	},
/turf/open/floor/plasteel,
/area/shuttle/escape)
"cR" = (
/obj/structure/shuttle/engine/heater{
	dir = 1
	},
/obj/structure/window/plasma/reinforced,
/turf/open/floor/plating/airless,
/area/shuttle/escape)
"dE" = (
/obj/structure/chair/comfy/shuttle{
	dir = 8
	},
/turf/open/floor/mineral/titanium,
/area/shuttle/escape)
"er" = (
/obj/machinery/light{
	dir = 1
	},
/obj/structure/chair/comfy/shuttle{
	dir = 4
	},
/turf/open/floor/mineral/titanium,
/area/shuttle/escape)
"et" = (
/obj/structure/window/reinforced{
	dir = 4
	},
/obj/structure/chair/comfy/shuttle{
	dir = 8
	},
/turf/open/floor/mineral/plastitanium/red,
/area/shuttle/escape)
"ez" = (
/turf/open/floor/mineral/plastitanium,
/area/shuttle/escape)
"eZ" = (
/obj/structure/shuttle/engine/propulsion/right{
	dir = 1
	},
/turf/open/floor/plating/airless,
/area/shuttle/escape)
"fz" = (
/obj/structure/sink{
	pixel_y = 20
	},
/turf/open/floor/mineral/titanium,
/area/shuttle/escape)
"fE" = (
/obj/machinery/door/firedoor/border_only{
	dir = 1
	},
/obj/machinery/door/firedoor/border_only,
/obj/machinery/door/airlock/public,
/turf/open/floor/mineral/titanium,
/area/shuttle/escape)
"fL" = (
/obj/structure/table/reinforced,
/obj/item/clipboard,
/obj/item/stamp,
/obj/machinery/door/firedoor/border_only{
	dir = 8
	},
/turf/open/floor/mineral/plastitanium/red,
/area/shuttle/escape)
"gb" = (
/obj/structure/chair/comfy/shuttle{
	dir = 8
	},
/obj/structure/window/reinforced{
	dir = 4
	},
/turf/open/floor/mineral/titanium,
/area/shuttle/escape)
"go" = (
/obj/structure/window/reinforced{
	dir = 4
	},
/turf/open/floor/mineral/titanium,
/area/shuttle/escape)
"gv" = (
/mob/living/simple_animal/bot/cleanbot{
	desc = "A little cleaning robot that after years of hard work, got promoted to captain and was given his own ship!";
	name = "Captain Cleanbot"
	},
/obj/structure/chair/comfy/teal,
/turf/open/floor/mineral/titanium,
/area/shuttle/escape)
"gz" = (
/turf/template_noop,
/area/template_noop)
"hK" = (
/obj/machinery/computer/arcade/battle,
/turf/open/floor/mineral/titanium,
/area/shuttle/escape)
"iw" = (
/obj/machinery/chem_dispenser/drinks/fullupgrade{
	dir = 4
	},
/obj/effect/turf_decal/tile/bar{
	dir = 1
	},
/obj/effect/turf_decal/tile/bar,
/obj/structure/table,
/turf/open/floor/plasteel,
/area/shuttle/escape)
"iB" = (
/obj/machinery/sleeper{
	dir = 8
	},
/turf/open/floor/mineral/titanium/blue,
/area/shuttle/escape)
"iS" = (
/obj/structure/fans/tiny,
/obj/machinery/door/airlock/external{
	name = "Horizon Corporation Shuttle"
	},
/obj/effect/turf_decal/stripes/line{
	dir = 1
	},
/obj/effect/turf_decal/stripes/line,
/turf/open/floor/plating/airless,
/area/shuttle/escape)
"iX" = (
/obj/machinery/scanner_gate/luxury_shuttle{
	layer = 2.6
	},
/obj/machinery/door/airlock/gold/glass{
	name = "First Class"
	},
/obj/machinery/door/firedoor/border_only,
/obj/machinery/door/firedoor/border_only{
	dir = 1
	},
/turf/open/floor/mineral/titanium,
/area/shuttle/escape)
"jv" = (
/obj/machinery/door/firedoor/border_only{
	dir = 1
	},
/turf/open/floor/mineral/titanium,
/area/shuttle/escape)
"jS" = (
/obj/machinery/light{
	dir = 8
	},
/obj/machinery/stasis{
	dir = 4
	},
/obj/machinery/defibrillator_mount/loaded{
	pixel_x = -28;
	pixel_y = -3
	},
/turf/open/floor/mineral/titanium/blue,
/area/shuttle/escape)
"ku" = (
/obj/machinery/portable_atmospherics/canister/air,
/obj/effect/decal/cleanable/dirt,
/turf/open/floor/plating,
/area/shuttle/escape)
"kw" = (
/obj/machinery/vending/wallmed{
	name = "Emergency NanoMed";
	use_power = 0
	},
/turf/closed/wall/mineral/titanium,
/area/shuttle/escape)
"kI" = (
/obj/structure/toilet,
/obj/machinery/light/small{
	dir = 1
	},
/turf/open/floor/mineral/titanium,
/area/shuttle/escape)
"kM" = (
/obj/machinery/stasis{
	dir = 4
	},
/turf/open/floor/mineral/titanium/white,
/area/shuttle/escape)
"lo" = (
/obj/structure/table/reinforced,
/obj/structure/window/reinforced,
/obj/structure/window/reinforced{
	dir = 8
	},
/obj/item/storage/box/zipties,
/obj/machinery/door/firedoor/border_only{
	dir = 8
	},
/obj/machinery/door/firedoor/border_only,
/turf/open/floor/mineral/plastitanium/red,
/area/shuttle/escape)
"lK" = (
/obj/structure/toilet{
	dir = 1
	},
/obj/machinery/light/small,
/turf/open/floor/mineral/titanium,
/area/shuttle/escape)
"ms" = (
/obj/machinery/door/airlock/titanium{
	name = "Cockpit";
	req_access_txt = "109"
	},
/obj/machinery/door/firedoor/border_only{
	dir = 1
	},
/obj/machinery/door/firedoor/border_only,
/turf/open/floor/mineral/titanium,
/area/shuttle/escape)
"mB" = (
/obj/item/scalpel{
	pixel_y = 12
	},
/obj/item/circular_saw,
/obj/item/retractor{
	pixel_x = 4
	},
/obj/item/hemostat{
	pixel_x = -4
	},
/obj/item/clothing/gloves/color/latex,
/obj/item/clothing/mask/surgical,
/obj/structure/table/reinforced,
/obj/effect/turf_decal/tile/blue{
	dir = 4
	},
/obj/effect/turf_decal/tile/blue{
	dir = 8
	},
/obj/item/surgicaldrill,
/obj/item/cautery,
/turf/open/floor/mineral/titanium/blue,
/area/shuttle/escape)
"mF" = (
/obj/machinery/door/airlock/external{
	name = "Horizon Corporation Shuttle"
	},
/obj/structure/fans/tiny,
/obj/docking_port/mobile/emergency,
/obj/effect/turf_decal/stripes/line{
	dir = 8
	},
/obj/effect/turf_decal/stripes/line{
	dir = 4
	},
/turf/closed/wall/mineral/titanium,
/area/shuttle/escape)
"mL" = (
/obj/structure/sign/poster/official/random{
	pixel_x = 32
	},
/turf/closed/wall/mineral/titanium,
/area/shuttle/escape)
"nm" = (
/obj/structure/chair/comfy/shuttle{
	dir = 4
	},
/obj/structure/window/reinforced{
	dir = 8
	},
/obj/machinery/light{
	dir = 1
	},
/turf/open/floor/mineral/titanium,
/area/shuttle/escape)
"ny" = (
/turf/closed/wall/mineral/titanium,
/area/shuttle/escape)
"ox" = (
/obj/machinery/door/firedoor/border_only,
/obj/machinery/door/window/southleft{
	name = "Brig";
	req_access_txt = "2"
	},
/turf/open/floor/mineral/plastitanium,
/area/shuttle/escape)
"pe" = (
/obj/effect/spawner/structure/window/shuttle,
/obj/machinery/door/firedoor/border_only{
	dir = 4
	},
/turf/open/floor/plating,
/area/shuttle/escape)
"pY" = (
/obj/machinery/door/firedoor/border_only{
	dir = 8
	},
/obj/effect/spawner/structure/window/shuttle,
/turf/open/floor/plating/airless,
/area/shuttle/escape)
"pZ" = (
/obj/structure/chair/comfy/shuttle{
	dir = 4
	},
/obj/structure/window/reinforced{
	dir = 8
	},
/obj/machinery/door/firedoor/border_only,
/turf/open/floor/mineral/titanium,
/area/shuttle/escape)
"qe" = (
/obj/structure/chair/comfy/shuttle{
	dir = 8
	},
/obj/structure/window/reinforced{
	dir = 4
	},
/obj/machinery/door/firedoor/border_only,
/turf/open/floor/mineral/titanium,
/area/shuttle/escape)
"qF" = (
/obj/structure/chair/comfy/shuttle{
	dir = 8
	},
/obj/structure/window/reinforced{
	dir = 4
	},
/turf/open/floor/mineral/plastitanium/red,
/area/shuttle/escape)
"qR" = (
/obj/structure/sink{
	dir = 4;
	pixel_x = 11
	},
/turf/open/floor/mineral/titanium/blue,
/area/shuttle/escape)
"rG" = (
/obj/structure/chair/comfy/shuttle{
	dir = 8
	},
/obj/structure/window/reinforced{
	dir = 4
	},
/obj/machinery/door/firedoor/border_only{
	dir = 1
	},
/turf/open/floor/mineral/titanium,
/area/shuttle/escape)
"rL" = (
/obj/machinery/computer/arcade/minesweeper,
/turf/open/floor/mineral/titanium,
/area/shuttle/escape)
"rV" = (
/obj/structure/table/wood/bar{
	boot_dir = 8
	},
/obj/effect/turf_decal/tile/bar{
	dir = 1
	},
/obj/effect/turf_decal/tile/bar,
/obj/machinery/door/firedoor/border_only{
	dir = 4
	},
/turf/open/floor/plasteel,
/area/shuttle/escape)
"sJ" = (
/obj/effect/turf_decal/tile/bar{
	dir = 1
	},
/obj/effect/turf_decal/tile/bar,
/obj/structure/chair/stool/bar{
	can_buckle = 1;
	name = "buckleable bar stool"
	},
/turf/open/floor/plasteel,
/area/shuttle/escape)
"tA" = (
/obj/machinery/door/firedoor/border_only,
/obj/machinery/door/firedoor/border_only{
	dir = 1
	},
/turf/open/floor/mineral/titanium,
/area/shuttle/escape)
"tR" = (
/turf/open/floor/grass,
/area/shuttle/escape)
"tW" = (
/obj/structure/chair{
	dir = 8
	},
/obj/item/cardboard_cutout{
	desc = "He seems to be ignoring you... Typical.";
	dir = 8;
	icon_state = "cutout_ntsec";
	name = "Officer Thomas"
	},
/turf/open/floor/mineral/plastitanium/red,
/area/shuttle/escape)
"up" = (
/obj/structure/sign/poster/official/random{
	pixel_x = -32
	},
/turf/open/floor/mineral/titanium,
/area/shuttle/escape)
"uA" = (
/obj/machinery/vending/toyliberationstation{
	age_restrictions = 0;
	extended_inventory = 1;
	pixel_x = -1
	},
/turf/open/floor/mineral/titanium,
/area/shuttle/escape)
"uG" = (
/obj/machinery/vending/boozeomat,
/obj/effect/turf_decal/tile/bar{
	dir = 1
	},
/obj/effect/turf_decal/tile/bar,
/turf/open/floor/plasteel,
/area/shuttle/escape)
"uH" = (
/obj/machinery/light{
	dir = 4
	},
/obj/structure/chair/comfy/shuttle{
	dir = 8
	},
/turf/open/floor/mineral/titanium,
/area/shuttle/escape)
"uQ" = (
/turf/open/floor/mineral/plastitanium/red,
/area/shuttle/escape)
"vT" = (
/obj/structure/chair/comfy/shuttle{
	dir = 4
	},
/obj/structure/window/reinforced{
	dir = 8
	},
/turf/open/floor/mineral/plastitanium/red,
/area/shuttle/escape)
"wb" = (
/obj/machinery/computer/emergency_shuttle{
	dir = 1
	},
/turf/open/floor/mineral/titanium/blue,
/area/shuttle/escape)
"wm" = (
/obj/machinery/door/firedoor/border_only{
	dir = 4
	},
/obj/effect/spawner/structure/window/shuttle,
/turf/open/floor/plating/airless,
/area/shuttle/escape)
"wK" = (
/obj/machinery/door/firedoor/border_only,
/obj/machinery/door/firedoor/border_only{
	dir = 1
	},
/obj/machinery/door/airlock/security{
	name = "Holding Cell 1";
	req_access_txt = "2"
	},
/turf/open/floor/mineral/plastitanium,
/area/shuttle/escape)
"wL" = (
/obj/structure/window/reinforced{
	dir = 8
	},
/obj/structure/chair/comfy/shuttle{
	dir = 4
	},
/turf/open/floor/mineral/plastitanium/red,
/area/shuttle/escape)
"wW" = (
/obj/structure/chair/comfy/shuttle,
/turf/open/floor/mineral/titanium,
/area/shuttle/escape)
"xl" = (
/obj/structure/table,
/obj/item/storage/lockbox,
/turf/open/floor/mineral/titanium/blue,
/area/shuttle/escape)
"xR" = (
/obj/structure/chair/comfy/shuttle{
	dir = 4
	},
/obj/machinery/light{
	dir = 1
	},
/turf/open/floor/mineral/plastitanium/red,
/area/shuttle/escape)
"xT" = (
/obj/structure/chair/comfy/shuttle{
	dir = 4
	},
/obj/structure/window/reinforced{
	dir = 8
	},
/obj/machinery/light{
	dir = 1
	},
/turf/open/floor/mineral/plastitanium/red,
/area/shuttle/escape)
"xW" = (
/obj/machinery/door/airlock/external{
	name = "Horizon Corporation Shuttle"
	},
/turf/closed/wall/mineral/titanium,
/area/shuttle/escape)
"yh" = (
/obj/structure/chair/comfy/shuttle{
	dir = 4
	},
/obj/machinery/door/firedoor/border_only{
	dir = 1
	},
/turf/open/floor/mineral/titanium,
/area/shuttle/escape)
"yt" = (
/obj/structure/table/wood/bar{
	boot_dir = 8
	},
/obj/effect/turf_decal/tile/bar{
	dir = 1
	},
/obj/effect/turf_decal/tile/bar,
/obj/machinery/door/firedoor/border_only{
	dir = 4
	},
/obj/item/reagent_containers/food/snacks/pizza/donkpocket,
/obj/item/kitchen/knife,
/turf/open/floor/plasteel,
/area/shuttle/escape)
"yz" = (
/obj/machinery/light,
/obj/structure/table,
/obj/item/storage/firstaid/regular{
	pixel_x = 2;
	pixel_y = 3
	},
/turf/open/floor/mineral/titanium,
/area/shuttle/escape)
"yH" = (
/obj/machinery/computer/arcade/orion_trail,
/turf/open/floor/mineral/titanium,
/area/shuttle/escape)
"yW" = (
/obj/structure/chair/comfy/shuttle{
	dir = 8
	},
/obj/structure/window/reinforced{
	dir = 4
	},
/obj/machinery/light{
	dir = 1
	},
/turf/open/floor/mineral/plastitanium/red,
/area/shuttle/escape)
"zn" = (
/obj/machinery/door/firedoor/border_only{
	dir = 4
	},
/obj/machinery/door/firedoor/border_only{
	dir = 8
	},
/obj/machinery/door/airlock/external{
	name = "Horizon Corporation Shuttle"
	},
/turf/open/floor/plating,
/area/shuttle/escape)
"zt" = (
/obj/structure/chair/comfy/shuttle{
	dir = 4
	},
/turf/open/floor/mineral/plastitanium/red,
/area/shuttle/escape)
"zB" = (
/obj/machinery/door/window/northright{
	name = "Security Desk";
	req_access_txt = "103"
	},
/obj/machinery/door/firedoor/border_only{
	dir = 1
	},
/turf/open/floor/mineral/plastitanium/red,
/area/shuttle/escape)
"zH" = (
/obj/structure/chair/comfy/shuttle{
	dir = 4
	},
/obj/structure/window/reinforced{
	dir = 8
	},
/obj/machinery/door/firedoor/border_only{
	dir = 1
	},
/turf/open/floor/mineral/titanium,
/area/shuttle/escape)
"zO" = (
/obj/machinery/door/firedoor/border_only,
/obj/machinery/door/firedoor/border_only{
	dir = 1
	},
/obj/machinery/door/airlock/security{
	name = "Holding Cell 2";
	req_access_txt = "2"
	},
/turf/open/floor/mineral/plastitanium,
/area/shuttle/escape)
"zU" = (
/obj/item/storage/box/donkpockets,
/obj/effect/turf_decal/tile/bar{
	dir = 1
	},
/obj/effect/turf_decal/tile/bar,
/obj/structure/table,
/turf/open/floor/plasteel,
/area/shuttle/escape)
"Ae" = (
/obj/structure/extinguisher_cabinet{
	pixel_y = -30
	},
/turf/open/floor/mineral/titanium,
/area/shuttle/escape)
"AF" = (
/obj/structure/chair/comfy/shuttle{
	dir = 8
	},
/obj/machinery/light{
	dir = 1
	},
/turf/open/floor/mineral/plastitanium/red,
/area/shuttle/escape)
"BQ" = (
/obj/item/storage/box/drinkingglasses,
/obj/item/reagent_containers/food/drinks/bottle/lizardwine,
/obj/effect/turf_decal/tile/bar{
	dir = 1
	},
/obj/effect/turf_decal/tile/bar,
/obj/structure/table,
/turf/open/floor/plasteel,
/area/shuttle/escape)
"Ch" = (
/turf/open/floor/mineral/titanium,
/area/shuttle/escape)
"Co" = (
/turf/open/floor/mineral/titanium/blue,
/area/shuttle/escape)
"Cx" = (
/obj/machinery/sleeper{
	dir = 8
	},
/turf/open/floor/mineral/titanium/white,
/area/shuttle/escape)
"CJ" = (
/obj/structure/table/reinforced,
/obj/structure/window/reinforced{
	dir = 8
	},
/obj/structure/window/reinforced{
	dir = 1
	},
/obj/machinery/recharger,
/obj/machinery/door/firedoor/border_only{
	dir = 8
	},
/obj/machinery/door/firedoor/border_only{
	dir = 1
	},
/turf/open/floor/mineral/plastitanium/red,
/area/shuttle/escape)
"CW" = (
/obj/structure/chair/comfy/shuttle{
	dir = 8
	},
/obj/machinery/door/firedoor/border_only,
/turf/open/floor/mineral/titanium,
/area/shuttle/escape)
"Dd" = (
/obj/effect/turf_decal/tile/bar{
	dir = 1
	},
/obj/effect/turf_decal/tile/bar,
/turf/open/floor/plasteel,
/area/shuttle/escape)
"Dw" = (
/obj/structure/table/optable,
/obj/machinery/defibrillator_mount/loaded{
	pixel_y = 28
	},
/turf/open/floor/mineral/titanium/blue,
/area/shuttle/escape)
"DE" = (
/obj/effect/decal/cleanable/blood/gibs/core,
/obj/item/reagent_containers/food/snacks/deadmouse,
/obj/effect/decal/cleanable/dirt,
/turf/open/floor/plating,
/area/shuttle/escape)
"DJ" = (
/obj/structure/chair/comfy/shuttle{
	dir = 8
	},
/turf/open/floor/mineral/plastitanium/red,
/area/shuttle/escape)
"Eb" = (
/obj/machinery/vending/coffee,
/turf/open/floor/mineral/titanium,
/area/shuttle/escape)
"Fd" = (
/obj/structure/chair/comfy/shuttle{
	dir = 4
	},
/obj/structure/window/reinforced{
	dir = 8
	},
/turf/open/floor/mineral/titanium,
/area/shuttle/escape)
"Fr" = (
/turf/closed/wall/mineral/titanium/nodiagonal,
/area/shuttle/escape)
"FE" = (
/obj/machinery/computer/communications{
	dir = 4
	},
/turf/open/floor/mineral/titanium/blue,
/area/shuttle/escape)
"FI" = (
/obj/machinery/door/firedoor/border_only{
	dir = 8
	},
/obj/machinery/door/firedoor/border_only{
	dir = 4
	},
/obj/machinery/door/airlock/external{
	name = "Horizon Corporation Shuttle"
	},
/turf/open/floor/plating,
/area/shuttle/escape)
"Gy" = (
/obj/structure/chair/comfy/shuttle{
	dir = 4
	},
/obj/machinery/door/firedoor/border_only,
/obj/structure/window/reinforced,
/turf/open/floor/mineral/plastitanium/red,
/area/shuttle/escape)
"GE" = (
/obj/effect/decal/cleanable/dirt,
/turf/open/floor/plating,
/area/shuttle/escape)
"GQ" = (
/obj/machinery/light{
	dir = 8
	},
/obj/structure/chair/comfy/shuttle{
	dir = 4
	},
/turf/open/floor/mineral/titanium,
/area/shuttle/escape)
"Hi" = (
/obj/machinery/door/firedoor/border_only{
	dir = 4
	},
/obj/effect/spawner/structure/window/shuttle,
/turf/open/floor/plating,
/area/shuttle/escape)
"Hu" = (
/obj/structure/sink{
	dir = 4;
	pixel_x = 11
	},
/turf/open/floor/mineral/titanium,
/area/shuttle/escape)
"Hy" = (
/obj/machinery/vending/medical,
/obj/machinery/light,
/turf/open/floor/mineral/titanium,
/area/shuttle/escape)
"HX" = (
/obj/structure/table,
/obj/item/storage/firstaid/toxin,
/obj/item/storage/firstaid/o2{
	pixel_x = 3;
	pixel_y = 3
	},
/obj/item/storage/firstaid/fire,
/obj/item/storage/firstaid/regular{
	pixel_x = 2;
	pixel_y = 3
	},
/turf/open/floor/mineral/titanium/blue,
/area/shuttle/escape)
"Io" = (
/obj/effect/spawner/structure/window/shuttle,
/obj/machinery/door/firedoor/border_only,
/turf/open/floor/plating,
/area/shuttle/escape)
"Iy" = (
/obj/effect/spawner/structure/window/shuttle,
/obj/machinery/door/firedoor/border_only{
	dir = 8
	},
/turf/open/floor/plating/airless,
/area/shuttle/escape)
"IY" = (
/obj/machinery/vending/cigarette,
/turf/open/floor/mineral/titanium,
/area/shuttle/escape)
"JB" = (
/turf/open/floor/plating,
/area/shuttle/escape)
"JQ" = (
/obj/machinery/computer/atmos_alert{
	dir = 1
	},
/turf/open/floor/mineral/titanium/blue,
/area/shuttle/escape)
"Kc" = (
/obj/structure/chair/comfy/shuttle{
	dir = 8
	},
/obj/machinery/door/firedoor/border_only,
/obj/structure/window/reinforced,
/turf/open/floor/mineral/plastitanium/red,
/area/shuttle/escape)
"Ki" = (
/obj/machinery/vending/snack/random,
/turf/open/floor/mineral/titanium,
/area/shuttle/escape)
"KA" = (
/obj/structure/chair/comfy/shuttle{
	dir = 4
	},
/obj/machinery/door/firedoor/border_only,
/turf/open/floor/mineral/titanium,
/area/shuttle/escape)
"KN" = (
/obj/structure/closet/crate,
/obj/effect/spawner/lootdrop/maintenance/eight,
/obj/machinery/light/small{
	dir = 8
	},
/obj/effect/decal/cleanable/dirt,
/turf/open/floor/plating,
/area/shuttle/escape)
"Lz" = (
/obj/structure/closet/crate,
/obj/effect/spawner/lootdrop/maintenance/eight,
/obj/machinery/light/small{
	dir = 4
	},
/obj/effect/decal/cleanable/dirt,
/turf/open/floor/plating,
/area/shuttle/escape)
"LL" = (
/obj/machinery/computer/station_alert{
	dir = 8
	},
/turf/open/floor/mineral/titanium/blue,
/area/shuttle/escape)
"LX" = (
/obj/structure/window/reinforced,
/obj/machinery/computer/secure_data/laptop{
	dir = 1;
	pixel_y = 4
	},
/obj/structure/table/reinforced,
/obj/machinery/door/firedoor/border_only,
/turf/open/floor/mineral/plastitanium/red,
/area/shuttle/escape)
"Mp" = (
/obj/machinery/vending/toyliberationstation{
	age_restrictions = 0;
	extended_inventory = 1
	},
/turf/open/floor/mineral/titanium,
/area/shuttle/escape)
"MC" = (
/obj/structure/window/reinforced{
	dir = 4
	},
/obj/structure/chair/comfy/shuttle{
	dir = 8
	},
/turf/open/floor/mineral/titanium,
/area/shuttle/escape)
"MT" = (
/obj/machinery/vending/medical,
/turf/open/floor/mineral/titanium/blue,
/area/shuttle/escape)
"NH" = (
/obj/machinery/light{
	dir = 1
	},
/obj/structure/chair/comfy/shuttle{
	dir = 8
	},
/turf/open/floor/mineral/titanium,
/area/shuttle/escape)
"Oi" = (
/obj/structure/table,
/obj/item/radio/off,
/turf/open/floor/mineral/titanium/blue,
/area/shuttle/escape)
"OW" = (
/obj/machinery/vending/autodrobe,
/turf/open/floor/mineral/titanium,
/area/shuttle/escape)
"PF" = (
/obj/machinery/vending/cola/blue,
/turf/open/floor/mineral/titanium,
/area/shuttle/escape)
"PV" = (
/obj/structure/table/reinforced,
/obj/item/paper_bin,
/obj/item/pen,
/obj/machinery/door/firedoor/border_only{
	dir = 8
	},
/turf/open/floor/mineral/plastitanium/red,
/area/shuttle/escape)
"Rr" = (
/obj/structure/mirror{
	pixel_y = 28
	},
/obj/machinery/light/small{
	dir = 8
	},
/obj/machinery/computer/operating,
/turf/open/floor/mineral/titanium/blue,
/area/shuttle/escape)
"RR" = (
/obj/structure/shuttle/engine/propulsion/left{
	dir = 1
	},
/turf/open/floor/plating/airless,
/area/shuttle/escape)
"Sf" = (
/obj/machinery/door/firedoor/border_only,
/obj/machinery/door/firedoor/border_only{
	dir = 1
	},
/obj/machinery/door/airlock/medical/glass{
	name = "Horizon Corporation Shuttle Infirmary"
	},
/turf/open/floor/mineral/titanium,
/area/shuttle/escape)
"Sx" = (
/obj/structure/chair/comfy/shuttle{
	dir = 4
	},
/obj/structure/sign/poster/official/random{
	pixel_x = -32
	},
/turf/open/floor/mineral/titanium,
/area/shuttle/escape)
"SH" = (
/obj/machinery/stasis{
	dir = 4
	},
/turf/open/floor/mineral/titanium,
/area/shuttle/escape)
"SM" = (
/obj/machinery/computer/aifixer{
	dir = 1
	},
/turf/open/floor/mineral/titanium/blue,
/area/shuttle/escape)
"Ty" = (
/turf/open/floor/mineral/titanium/white,
/area/shuttle/escape)
"TD" = (
/obj/machinery/vending/cola/random,
/obj/machinery/light{
	dir = 1
	},
/turf/open/floor/mineral/titanium,
/area/shuttle/escape)
"UP" = (
/obj/structure/chair/comfy/shuttle{
	dir = 8
	},
/obj/machinery/door/firedoor/border_only{
	dir = 1
	},
/turf/open/floor/mineral/titanium,
/area/shuttle/escape)
"UU" = (
/obj/structure/table,
/obj/item/assembly/flash/handheld,
/turf/open/floor/mineral/titanium/blue,
/area/shuttle/escape)
"Wb" = (
/obj/machinery/door/firedoor/border_only,
/obj/machinery/door/firedoor/border_only{
	dir = 1
	},
/obj/machinery/door/airlock/public,
/turf/open/floor/mineral/titanium,
/area/shuttle/escape)
"Wz" = (
/obj/machinery/space_heater,
/obj/effect/decal/cleanable/dirt,
/turf/open/floor/plating,
/area/shuttle/escape)
"WV" = (
/obj/machinery/door/firedoor/border_only,
/turf/open/floor/mineral/titanium,
/area/shuttle/escape)
"Xp" = (
/obj/structure/window/reinforced{
	dir = 8
	},
/obj/structure/chair/comfy/shuttle{
	dir = 4
	},
/turf/open/floor/mineral/titanium,
/area/shuttle/escape)
"XI" = (
/obj/machinery/microwave{
	desc = "Cooks and boils stuff, somehow.";
	pixel_y = 5
	},
/obj/effect/turf_decal/tile/bar{
	dir = 1
	},
/obj/effect/turf_decal/tile/bar,
/obj/structure/table,
/turf/open/floor/plasteel,
/area/shuttle/escape)
"XQ" = (
/obj/structure/chair/comfy/shuttle{
	dir = 4
	},
/turf/open/floor/mineral/titanium,
/area/shuttle/escape)
"YB" = (
/obj/structure/chair/comfy/shuttle{
	dir = 8
	},
/obj/structure/sign/poster/official/random{
	pixel_x = 32
	},
/turf/open/floor/mineral/titanium,
/area/shuttle/escape)
"YG" = (
/obj/structure/window/reinforced{
	dir = 4
	},
/obj/machinery/light{
	dir = 1
	},
/turf/open/floor/mineral/titanium,
/area/shuttle/escape)
"YP" = (
/obj/machinery/sleeper{
	dir = 8
	},
/turf/open/floor/mineral/titanium,
/area/shuttle/escape)
"Zq" = (
/obj/machinery/door/firedoor/border_only{
	dir = 4
	},
/obj/machinery/door/firedoor/border_only{
	dir = 8
	},
/obj/machinery/door/airlock/medical/glass{
	name = "Horizon Corporation Shuttle Infirmary"
	},
/turf/open/floor/mineral/titanium/blue,
/area/shuttle/escape)
"ZA" = (
/obj/structure/chair/comfy/shuttle{
	dir = 8
	},
/obj/structure/window/reinforced{
	dir = 4
	},
/obj/machinery/light{
	dir = 1
	},
/turf/open/floor/mineral/titanium,
/area/shuttle/escape)

(1,1,1) = {"
ny
ny
ny
ny
ny
ny
ny
ny
ny
ny
ny
ny
ny
ny
ny
ny
ny
ny
ny
xW
ny
mF
ny
ny
ny
ny
ny
ny
ny
ny
ny
ny
ny
gz
gz
gz
gz
gz
gz
gz
"}
(2,1,1) = {"
RR
cR
Ch
Ch
Ch
yh
XQ
XQ
ny
XQ
XQ
XQ
XQ
ny
SH
SH
SH
ny
Ch
Ch
WV
Ch
ny
Wz
JB
ku
ny
zU
BQ
cN
iw
uG
ny
ny
gz
gz
gz
gz
gz
gz
"}
(3,1,1) = {"
RR
cR
wW
Ch
Ch
jv
Ch
Ch
tA
Ch
Ch
Ch
Ch
Sf
Ch
Ch
Ch
Sf
Ch
Ch
WV
Ch
ny
Lz
JB
GE
ny
XI
Dd
Dd
Dd
Dd
Dd
ny
ny
gz
gz
gz
gz
gz
"}
(4,1,1) = {"
RR
cR
wW
Ch
Ch
rG
gb
gb
ny
ZA
gb
gb
gb
ny
fz
Ch
Hy
ny
YG
go
bP
Ch
ny
ny
FI
ny
ny
ny
aF
rV
yt
ay
rV
Fr
ny
ny
gz
gz
gz
gz
"}
(5,1,1) = {"
ny
ny
wW
Ch
Ch
zH
Fd
Fd
ny
nm
Fd
Fd
Fd
ny
fz
Ch
Hy
ny
nm
Fd
pZ
Ch
ny
GQ
Ch
GQ
Sx
KA
Ch
sJ
sJ
sJ
sJ
up
Eb
ny
ny
gz
gz
gz
"}
(6,1,1) = {"
gz
ny
wW
Ch
Ch
jv
Ch
Ch
tA
Ch
Ch
Ch
Ch
Sf
Ch
Ch
Ch
Sf
Ch
Ch
WV
Ch
iX
Ch
Ch
Ch
Ch
WV
Ch
Ch
Ch
Ch
Ch
Ch
PF
ny
ny
ny
ny
ny
"}
(7,1,1) = {"
gz
iS
Ch
Ch
Ch
UP
dE
dE
ny
dE
dE
dE
dE
ny
YP
YP
YP
ny
dE
dE
CW
Ch
ny
gb
Ch
MC
gb
qe
Ch
CJ
fL
PV
lo
Ch
yz
ny
FE
Oi
xl
Io
"}
(8,1,1) = {"
gz
ny
Ki
Ch
Ch
ny
ny
ny
ny
ny
pY
pY
ny
ny
Iy
pY
pY
ny
ny
ny
ny
Ch
ny
Mp
Ch
Xp
Fd
pZ
Ch
zB
uQ
tW
LX
Ch
Ch
ny
NH
wW
JQ
Io
"}
(9,1,1) = {"
gz
ny
TD
Ch
Ch
fE
Hu
lK
ny
tR
tR
tR
tR
ny
tR
tR
tR
ny
kI
Hu
Wb
Ch
ny
IY
Ch
Ch
Ch
WV
Ae
ny
ny
ny
kw
Ch
Ch
ms
Ch
gv
wb
Io
"}
(10,1,1) = {"
gz
ny
Ki
Ch
Ch
ny
ny
ny
ny
ny
wm
wm
ny
ny
ny
ny
ny
ny
ny
ny
ny
Ch
ny
uA
Ch
MC
gb
qe
Ch
Ty
aZ
Ty
Ty
Ch
Ch
ny
er
wW
SM
Io
"}
(11,1,1) = {"
gz
iS
Ch
Ch
Ch
yh
XQ
XQ
ny
XQ
XQ
XQ
XQ
ny
zt
zt
zt
ny
zt
zt
Gy
Ch
ny
Fd
Ch
Xp
Fd
pZ
Ch
Ty
Ty
Ty
Ty
Ch
yz
ny
LL
UU
bu
Io
"}
(12,1,1) = {"
gz
ny
wW
Ch
Ch
jv
Ch
Ch
tA
Ch
Ch
Ch
Ch
ny
ez
ez
ez
wK
ez
ez
ox
Ch
iX
Ch
Ch
Ch
Ch
WV
Ch
yH
hK
rL
Ch
Ch
Ch
ny
ny
ny
ny
ny
"}
(13,1,1) = {"
ny
ny
wW
Ch
Ch
rG
gb
gb
ny
ZA
gb
gb
gb
ny
yW
et
qF
ny
AF
ez
Kc
Ch
ny
uH
Ch
uH
YB
CW
ny
ny
ny
ny
Zq
mL
OW
ny
ny
gz
gz
gz
"}
(14,1,1) = {"
eZ
cR
wW
Ch
Ch
zH
Fd
Fd
ny
nm
Fd
Fd
Fd
ny
xT
wL
vT
ny
xR
ez
Gy
Ch
ny
ny
zn
ny
ny
ny
mB
kM
jS
MT
Co
ny
ny
ny
gz
gz
gz
gz
"}
(15,1,1) = {"
eZ
cR
wW
Ch
Ch
jv
Ch
Ch
tA
Ch
Ch
Ch
Ch
ny
ez
ez
ez
zO
ez
ez
ox
Ch
ny
KN
JB
GE
ny
Rr
Ty
Ty
Ty
Co
Co
ny
ny
gz
gz
gz
gz
gz
"}
(16,1,1) = {"
eZ
cR
Ch
Ch
Ch
UP
dE
dE
ny
dE
dE
dE
dE
ny
DJ
DJ
DJ
ny
DJ
DJ
Kc
Ch
ny
DE
JB
ku
ny
Dw
qR
Cx
iB
HX
ny
ny
gz
gz
gz
gz
gz
gz
"}
(17,1,1) = {"
ny
ny
ny
ny
ny
ny
ny
ny
ny
ny
ny
ny
ny
ny
ny
ny
ny
ny
ny
ny
ny
ny
ny
ny
ny
ny
ny
Hi
Hi
pe
pe
pe
ny
gz
gz
gz
gz
gz
gz
gz
"}
