//MAP CONVERTED BY dmm2tgm.py THIS HEADER COMMENT PREVENTS RECONVERSION, DO NOT REMOVE
"aD" = (
/obj/structure/toilet{
	dir = 1
	},
/obj/machinery/light/small,
/turf/open/floor/mineral/titanium,
/area/shuttle/escape)
"aZ" = (
/obj/machinery/vending/boozeomat,
/obj/effect/turf_decal/tile/bar{
	dir = 1
	},
/obj/effect/turf_decal/tile/bar,
/turf/open/floor/plasteel,
/area/crew_quarters/kitchen)
"bF" = (
/obj/machinery/door/firedoor/border_only,
/turf/open/floor/mineral/titanium,
/area/shuttle/escape)
"bZ" = (
/obj/structure/closet/crate,
/obj/effect/spawner/lootdrop/maintenance/eight,
/obj/machinery/light/small{
	dir = 8
	},
/obj/effect/decal/cleanable/dirt,
/turf/open/floor/plating,
/area/shuttle/escape)
"cz" = (
/turf/template_noop,
/area/template_noop)
"cM" = (
/obj/machinery/portable_atmospherics/canister/air,
/obj/effect/decal/cleanable/dirt,
/turf/open/floor/plating,
/area/shuttle/escape)
"dn" = (
/obj/structure/chair/comfy/shuttle{
	dir = 4
	},
/turf/open/floor/mineral/titanium,
/area/shuttle/escape)
"do" = (
/obj/structure/chair/comfy/shuttle{
	dir = 4
	},
/obj/structure/window/reinforced{
	dir = 8
	},
/obj/machinery/door/firedoor/border_only{
	dir = 1
	},
/turf/open/floor/mineral/titanium,
/area/shuttle/escape)
"dy" = (
/obj/machinery/door/firedoor/border_only{
	dir = 1
	},
/turf/open/floor/mineral/titanium,
/area/shuttle/escape)
"dC" = (
/obj/machinery/vending/coffee,
/turf/open/floor/mineral/titanium,
/area/shuttle/escape)
"er" = (
/obj/structure/chair/comfy/shuttle{
	dir = 8
	},
/obj/structure/sign/poster/official/random{
	pixel_x = 32
	},
/turf/open/floor/mineral/titanium,
/area/shuttle/escape)
"eN" = (
/obj/structure/sign/poster/official/random{
	pixel_x = 32
	},
/turf/closed/wall/mineral/titanium,
/area/shuttle/escape)
"fk" = (
/obj/structure/table/wood/bar{
	boot_dir = 8
	},
/obj/effect/turf_decal/tile/bar{
	dir = 1
	},
/obj/effect/turf_decal/tile/bar,
/obj/machinery/door/firedoor/border_only{
	dir = 4
	},
/obj/item/reagent_containers/food/snacks/pizza/donkpocket,
/obj/item/kitchen/knife,
/turf/open/floor/plasteel,
/area/crew_quarters/kitchen)
"gm" = (
/obj/machinery/door/airlock/titanium{
	name = "Cockpit";
	req_access_txt = "109"
	},
/obj/machinery/door/firedoor/border_only{
	dir = 1
	},
/obj/machinery/door/firedoor/border_only,
/turf/open/floor/mineral/titanium,
/area/shuttle/escape)
"hu" = (
/turf/open/floor/mineral/titanium,
/area/shuttle/escape)
"id" = (
/obj/structure/table,
/obj/item/radio/off,
/turf/open/floor/mineral/titanium/blue,
/area/shuttle/escape)
"ih" = (
/obj/structure/shuttle/engine/propulsion/right{
	dir = 1
	},
/turf/open/floor/plating/airless,
/area/shuttle/escape)
"ja" = (
/obj/effect/spawner/structure/window/shuttle,
/obj/machinery/door/firedoor/border_only,
/turf/open/floor/plating,
/area/shuttle/escape)
"jA" = (
/obj/machinery/vending/cigarette,
/turf/open/floor/mineral/titanium,
/area/shuttle/escape)
"jB" = (
/obj/structure/table/wood/bar{
	boot_dir = 8
	},
/obj/effect/turf_decal/tile/bar{
	dir = 1
	},
/obj/item/storage/box/mre,
/obj/machinery/door/firedoor/border_only{
	dir = 4
	},
/turf/open/floor/plasteel,
/area/crew_quarters/kitchen)
"jF" = (
/obj/structure/chair/comfy/shuttle{
	dir = 4
	},
/obj/structure/sign/poster/official/random{
	pixel_x = -32
	},
/turf/open/floor/mineral/titanium,
/area/shuttle/escape)
"jH" = (
/obj/machinery/door/firedoor/border_only,
/obj/machinery/door/firedoor/border_only{
	dir = 1
	},
/turf/open/floor/mineral/titanium,
/area/shuttle/escape)
"kE" = (
/turf/open/floor/mineral/titanium/blue,
/area/shuttle/escape)
"kK" = (
/obj/structure/chair/comfy/shuttle{
	dir = 8
	},
/obj/structure/window/reinforced{
	dir = 4
	},
/obj/machinery/door/firedoor/border_only,
/turf/open/floor/mineral/titanium,
/area/shuttle/escape)
"lg" = (
/obj/machinery/microwave{
	desc = "Cooks and boils stuff, somehow.";
	pixel_y = 5
	},
/obj/effect/turf_decal/tile/bar{
	dir = 1
	},
/obj/effect/turf_decal/tile/bar,
/obj/structure/table,
/turf/open/floor/plasteel,
/area/shuttle/escape)
"my" = (
/obj/machinery/stasis{
	dir = 4
	},
/turf/open/floor/mineral/titanium,
/area/shuttle/escape)
"mC" = (
/obj/machinery/space_heater,
/obj/effect/decal/cleanable/dirt,
/turf/open/floor/plating,
/area/shuttle/escape)
"mJ" = (
/obj/structure/table,
/obj/item/assembly/flash/handheld,
/turf/open/floor/mineral/titanium/blue,
/area/shuttle/escape)
"nI" = (
/obj/structure/chair/comfy/shuttle{
	dir = 4
	},
/obj/machinery/door/firedoor/border_only{
	dir = 1
	},
/turf/open/floor/mineral/titanium,
/area/shuttle/escape)
"nQ" = (
/obj/machinery/vending/toyliberationstation{
	age_restrictions = 0;
	extended_inventory = 1;
	pixel_x = -1
	},
/turf/open/floor/mineral/titanium,
/area/shuttle/escape)
"oo" = (
/obj/structure/mirror{
	pixel_y = 28
	},
/obj/machinery/light/small{
	dir = 8
	},
/obj/machinery/computer/operating,
/turf/open/floor/mineral/titanium/blue,
/area/shuttle/escape)
"pn" = (
/obj/machinery/computer/arcade/orion_trail,
/turf/open/floor/mineral/titanium,
/area/shuttle/escape)
"pX" = (
/obj/machinery/door/firedoor/border_only{
	dir = 8
	},
/obj/effect/spawner/structure/window/shuttle,
/turf/open/floor/plating/airless,
/area/shuttle/escape)
"qb" = (
/obj/machinery/stasis{
	dir = 4
	},
/turf/open/floor/mineral/titanium/white,
/area/shuttle/escape)
"qd" = (
/obj/structure/chair/comfy/shuttle{
	dir = 8
	},
/obj/structure/window/reinforced{
	dir = 4
	},
/obj/machinery/light{
	dir = 1
	},
/turf/open/floor/mineral/titanium,
/area/shuttle/escape)
"qV" = (
/obj/structure/table/optable,
/obj/machinery/defibrillator_mount/loaded{
	pixel_y = 28
	},
/turf/open/floor/mineral/titanium/blue,
/area/shuttle/escape)
"si" = (
/mob/living/simple_animal/bot/cleanbot{
	desc = "A little cleaning robot that after years of hard work, got promoted to captain and was given his own ship!";
	name = "Captain Cleanbot"
	},
/obj/structure/chair/comfy/teal,
/turf/open/floor/mineral/titanium,
/area/shuttle/escape)
"st" = (
/obj/machinery/sleeper{
	dir = 8
	},
/turf/open/floor/mineral/titanium/blue,
/area/shuttle/escape)
"sB" = (
/obj/machinery/vending/autodrobe,
/turf/open/floor/mineral/titanium,
/area/shuttle/escape)
"sN" = (
/obj/structure/chair/comfy/shuttle{
	dir = 4
	},
/obj/structure/window/reinforced{
	dir = 8
	},
/turf/open/floor/mineral/titanium,
/area/shuttle/escape)
"sO" = (
/obj/machinery/chem_dispenser/drinks/fullupgrade{
	dir = 4
	},
/obj/effect/turf_decal/tile/bar{
	dir = 1
	},
/obj/effect/turf_decal/tile/bar,
/obj/structure/table,
/turf/open/floor/plasteel,
/area/crew_quarters/kitchen)
"tA" = (
/obj/structure/window/reinforced{
	dir = 4
	},
/obj/structure/chair/comfy/shuttle{
	dir = 8
	},
/turf/open/floor/mineral/titanium,
/area/shuttle/escape)
"ui" = (
/obj/machinery/door/window/eastleft{
	name = "bar counter door"
	},
/obj/effect/turf_decal/tile/bar{
	dir = 1
	},
/obj/effect/turf_decal/tile/bar,
/obj/machinery/door/firedoor/border_only{
	dir = 4
	},
/turf/open/floor/plasteel,
/area/crew_quarters/kitchen)
"vd" = (
/obj/machinery/sleeper{
	dir = 8
	},
/turf/open/floor/mineral/titanium/white,
/area/shuttle/escape)
"vO" = (
/obj/structure/fans/tiny,
/obj/machinery/door/airlock/external{
	name = "Horizon Corporation Shuttle"
	},
/obj/effect/turf_decal/stripes/line{
	dir = 1
	},
/obj/effect/turf_decal/stripes/line,
/turf/open/floor/plating/airless,
/area/shuttle/escape)
"vR" = (
/obj/machinery/vending/cola/random,
/obj/machinery/light{
	dir = 1
	},
/turf/open/floor/mineral/titanium,
/area/shuttle/escape)
"xb" = (
/obj/structure/chair/comfy/shuttle{
	dir = 4
	},
/obj/structure/window/reinforced{
	dir = 8
	},
/obj/machinery/door/firedoor/border_only,
/turf/open/floor/mineral/titanium,
/area/shuttle/escape)
"xl" = (
/obj/structure/sink{
	pixel_y = 20
	},
/turf/open/floor/mineral/titanium,
/area/shuttle/escape)
"xp" = (
/obj/structure/table/reinforced,
/obj/structure/window/reinforced{
	dir = 8
	},
/obj/structure/window/reinforced{
	dir = 1
	},
/obj/machinery/recharger,
/obj/machinery/door/firedoor/border_only{
	dir = 8
	},
/obj/machinery/door/firedoor/border_only{
	dir = 1
	},
/turf/open/floor/mineral/plastitanium/red,
/area/shuttle/escape)
"xH" = (
/obj/structure/closet/crate,
/obj/effect/spawner/lootdrop/maintenance/eight,
/obj/machinery/light/small{
	dir = 4
	},
/obj/effect/decal/cleanable/dirt,
/turf/open/floor/plating,
/area/shuttle/escape)
"xN" = (
/obj/structure/chair{
	dir = 8
	},
/obj/item/cardboard_cutout{
	desc = "He seems to be ignoring you... Typical.";
	dir = 8;
	icon_state = "cutout_ntsec";
	name = "Officer Thomas"
	},
/turf/open/floor/mineral/plastitanium/red,
/area/shuttle/escape)
"xZ" = (
/obj/machinery/vending/toyliberationstation{
	age_restrictions = 0;
	extended_inventory = 1
	},
/turf/open/floor/mineral/titanium,
/area/shuttle/escape)
"yc" = (
/obj/structure/table/reinforced,
/obj/item/paper_bin,
/obj/item/pen,
/obj/machinery/door/firedoor/border_only{
	dir = 8
	},
/turf/open/floor/mineral/plastitanium/red,
/area/shuttle/escape)
"yj" = (
/obj/machinery/door/firedoor/border_only{
	dir = 1
	},
/obj/machinery/door/firedoor/border_only,
/turf/open/floor/mineral/titanium,
/area/shuttle/escape)
"yo" = (
/obj/machinery/light,
/obj/structure/table,
/obj/item/storage/firstaid/regular{
	pixel_x = 2;
	pixel_y = 3
	},
/turf/open/floor/mineral/titanium,
/area/shuttle/escape)
"yB" = (
/obj/machinery/door/firedoor/border_only{
	dir = 4
	},
/obj/machinery/door/firedoor/border_only{
	dir = 8
	},
/obj/machinery/door/airlock/medical/glass{
	name = "Horizon Corporation Shuttle Infirmary"
	},
/turf/open/floor/mineral/titanium/blue,
/area/shuttle/escape)
"yZ" = (
/obj/structure/table/reinforced,
/obj/item/clipboard,
/obj/item/stamp,
/obj/machinery/door/firedoor/border_only{
	dir = 8
	},
/turf/open/floor/mineral/plastitanium/red,
/area/shuttle/escape)
"ze" = (
/obj/machinery/computer/atmos_alert{
	dir = 1
	},
/turf/open/floor/mineral/titanium/blue,
/area/shuttle/escape)
"zP" = (
/obj/machinery/computer/communications{
	dir = 4
	},
/turf/open/floor/mineral/titanium/blue,
/area/shuttle/escape)
"AS" = (
/obj/structure/chair/comfy/shuttle{
	dir = 4
	},
/obj/structure/window/reinforced{
	dir = 8
	},
/obj/machinery/light{
	dir = 1
	},
/turf/open/floor/mineral/titanium,
/area/shuttle/escape)
"Bp" = (
/obj/structure/chair/comfy/shuttle{
	dir = 8
	},
/turf/open/floor/mineral/titanium,
/area/shuttle/escape)
"Br" = (
/turf/open/floor/mineral/plastitanium/red,
/area/shuttle/escape)
"BA" = (
/turf/closed/wall/mineral/titanium,
/area/shuttle/escape)
"Cc" = (
/obj/machinery/door/airlock/external{
	name = "Horizon Corporation Shuttle"
	},
/obj/structure/fans/tiny,
/obj/docking_port/mobile/emergency,
/obj/effect/turf_decal/stripes/line{
	dir = 8
	},
/obj/effect/turf_decal/stripes/line{
	dir = 4
	},
/turf/closed/wall/mineral/titanium,
/area/shuttle/escape)
"Ce" = (
/obj/structure/table/reinforced,
/obj/structure/window/reinforced,
/obj/structure/window/reinforced{
	dir = 8
	},
/obj/item/storage/box/zipties,
/obj/machinery/door/firedoor/border_only{
	dir = 8
	},
/obj/machinery/door/firedoor/border_only,
/turf/open/floor/mineral/plastitanium/red,
/area/shuttle/escape)
"Cf" = (
/obj/structure/chair/comfy/shuttle{
	dir = 8
	},
/obj/structure/window/reinforced{
	dir = 4
	},
/turf/open/floor/mineral/titanium,
/area/shuttle/escape)
"Cm" = (
/obj/structure/table,
/obj/item/gps{
	gpstag = "RECOV"
	},
/turf/open/floor/mineral/titanium/blue,
/area/shuttle/escape)
"CM" = (
/obj/item/scalpel{
	pixel_y = 12
	},
/obj/item/circular_saw,
/obj/item/retractor{
	pixel_x = 4
	},
/obj/item/hemostat{
	pixel_x = -4
	},
/obj/item/clothing/gloves/color/latex,
/obj/item/clothing/mask/surgical,
/obj/structure/table/reinforced,
/obj/effect/turf_decal/tile/blue{
	dir = 4
	},
/obj/effect/turf_decal/tile/blue{
	dir = 8
	},
/obj/item/surgicaldrill,
/obj/item/cautery,
/turf/open/floor/mineral/titanium/blue,
/area/shuttle/escape)
"CQ" = (
/obj/machinery/light{
	dir = 1
	},
/obj/structure/chair/comfy/shuttle{
	dir = 8
	},
/turf/open/floor/mineral/titanium,
/area/shuttle/escape)
"CR" = (
/obj/effect/decal/cleanable/blood/gibs/core,
/obj/item/reagent_containers/food/snacks/deadmouse,
/obj/effect/decal/cleanable/dirt,
/turf/open/floor/plating,
/area/shuttle/escape)
"Dj" = (
/obj/machinery/light{
	dir = 1
	},
/obj/structure/chair/comfy/shuttle{
	dir = 4
	},
/turf/open/floor/mineral/titanium,
/area/shuttle/escape)
"DV" = (
/obj/machinery/door/firedoor/border_only{
	dir = 4
	},
/obj/machinery/door/firedoor/border_only{
	dir = 8
	},
/obj/machinery/door/airlock/external{
	name = "Horizon Corporation Shuttle"
	},
/turf/open/floor/plating,
/area/shuttle/escape)
"DY" = (
/obj/structure/chair/comfy/shuttle,
/turf/open/floor/mineral/titanium,
/area/shuttle/escape)
"Ff" = (
/obj/machinery/door/firedoor/border_only,
/obj/machinery/door/firedoor/border_only{
	dir = 1
	},
/obj/machinery/door/airlock/medical/glass{
	name = "Horizon Corporation Shuttle Infirmary"
	},
/turf/open/floor/mineral/titanium,
/area/shuttle/escape)
"Fi" = (
/obj/machinery/scanner_gate/luxury_shuttle{
	layer = 2.6
	},
/obj/machinery/door/airlock/gold/glass{
	name = "First Class"
	},
/obj/machinery/door/firedoor/border_only,
/obj/machinery/door/firedoor/border_only{
	dir = 1
	},
/turf/open/floor/mineral/titanium,
/area/shuttle/escape)
"FW" = (
/obj/machinery/computer/aifixer{
	dir = 1
	},
/turf/open/floor/mineral/titanium/blue,
/area/shuttle/escape)
"GB" = (
/obj/structure/sink{
	dir = 4;
	pixel_x = 11
	},
/turf/open/floor/mineral/titanium,
/area/shuttle/escape)
"Hb" = (
/obj/effect/turf_decal/tile/bar{
	dir = 1
	},
/obj/effect/turf_decal/tile/bar,
/turf/open/floor/plasteel,
/area/crew_quarters/kitchen)
"Hp" = (
/obj/effect/spawner/structure/window/shuttle,
/obj/machinery/door/firedoor/border_only{
	dir = 4
	},
/turf/open/floor/plating,
/area/shuttle/escape)
"Hu" = (
/obj/structure/sink{
	dir = 4;
	pixel_x = 11
	},
/turf/open/floor/mineral/titanium/blue,
/area/shuttle/escape)
"Ii" = (
/obj/structure/extinguisher_cabinet{
	pixel_y = -30
	},
/turf/open/floor/mineral/titanium,
/area/shuttle/escape)
"Ip" = (
/obj/effect/turf_decal/tile/bar{
	dir = 1
	},
/obj/effect/turf_decal/tile/bar,
/obj/structure/chair/stool/bar{
	can_buckle = 1;
	name = "buckleable bar stool"
	},
/turf/open/floor/plasteel,
/area/shuttle/escape)
"Is" = (
/obj/machinery/door/window/northright{
	name = "Security Desk";
	req_access_txt = "103"
	},
/obj/machinery/door/firedoor/border_only{
	dir = 1
	},
/turf/open/floor/mineral/plastitanium/red,
/area/shuttle/escape)
"Iv" = (
/obj/machinery/light{
	dir = 8
	},
/obj/structure/chair/comfy/shuttle{
	dir = 4
	},
/turf/open/floor/mineral/titanium,
/area/shuttle/escape)
"Iy" = (
/turf/closed/wall/mineral/titanium/nodiagonal,
/area/shuttle/escape)
"Jz" = (
/obj/machinery/vending/snack/random,
/turf/open/floor/mineral/titanium,
/area/shuttle/escape)
"JU" = (
/obj/structure/chair/comfy/shuttle{
	dir = 8
	},
/obj/machinery/door/firedoor/border_only,
/turf/open/floor/mineral/titanium,
/area/shuttle/escape)
"Ka" = (
/obj/structure/table,
/obj/item/storage/firstaid/toxin,
/obj/item/storage/firstaid/o2{
	pixel_x = 3;
	pixel_y = 3
	},
/obj/item/storage/firstaid/fire,
/obj/item/storage/firstaid/regular{
	pixel_x = 2;
	pixel_y = 3
	},
/turf/open/floor/mineral/titanium/blue,
/area/shuttle/escape)
"Lg" = (
/obj/item/storage/box/donkpockets,
/obj/effect/turf_decal/tile/bar{
	dir = 1
	},
/obj/effect/turf_decal/tile/bar,
/obj/structure/table,
/turf/open/floor/plasteel,
/area/shuttle/escape)
"LF" = (
/obj/machinery/door/firedoor/border_only{
	dir = 4
	},
/obj/effect/spawner/structure/window/shuttle,
/turf/open/floor/plating,
/area/shuttle/escape)
"Mc" = (
/obj/machinery/vending/cola/blue,
/turf/open/floor/mineral/titanium,
/area/shuttle/escape)
"Mg" = (
/obj/machinery/computer/arcade/battle,
/turf/open/floor/mineral/titanium,
/area/shuttle/escape)
"Mp" = (
/obj/structure/table/wood/bar{
	boot_dir = 8
	},
/obj/effect/turf_decal/tile/bar{
	dir = 1
	},
/obj/effect/turf_decal/tile/bar,
/obj/machinery/door/firedoor/border_only{
	dir = 4
	},
/turf/open/floor/plasteel,
/area/crew_quarters/kitchen)
"MV" = (
/obj/structure/window/reinforced{
	dir = 8
	},
/obj/structure/chair/comfy/shuttle{
	dir = 4
	},
/turf/open/floor/mineral/titanium,
/area/shuttle/escape)
"Nd" = (
/obj/machinery/vending/medical,
/turf/open/floor/mineral/titanium/blue,
/area/shuttle/escape)
"Nw" = (
/obj/machinery/chem_dispenser/drinks/beer/fullupgrade{
	dir = 4
	},
/obj/effect/turf_decal/tile/bar{
	dir = 1
	},
/obj/effect/turf_decal/tile/bar,
/obj/structure/table,
/obj/machinery/light{
	dir = 8
	},
/turf/open/floor/plasteel,
/area/crew_quarters/kitchen)
"Nx" = (
/obj/machinery/door/firedoor/border_only{
	dir = 1
	},
/obj/machinery/door/firedoor/border_only,
/obj/machinery/door/airlock/public,
/turf/open/floor/mineral/titanium,
/area/shuttle/escape)
"NN" = (
/obj/machinery/sleeper{
	dir = 8
	},
/turf/open/floor/mineral/titanium,
/area/shuttle/escape)
"Oh" = (
/turf/open/floor/grass,
/area/shuttle/escape)
"OC" = (
/obj/machinery/light{
	dir = 8
	},
/obj/machinery/stasis{
	dir = 4
	},
/obj/machinery/defibrillator_mount/loaded{
	pixel_x = -28;
	pixel_y = -3
	},
/turf/open/floor/mineral/titanium/blue,
/area/shuttle/escape)
"OD" = (
/obj/structure/chair/comfy/shuttle{
	dir = 8
	},
/obj/machinery/door/firedoor/border_only{
	dir = 1
	},
/turf/open/floor/mineral/titanium,
/area/shuttle/escape)
"OJ" = (
/obj/structure/sign/poster/official/random{
	pixel_x = -32
	},
/turf/open/floor/mineral/titanium,
/area/shuttle/escape)
"Pe" = (
/obj/structure/shuttle/engine/propulsion/left{
	dir = 1
	},
/turf/open/floor/plating/airless,
/area/shuttle/escape)
"PX" = (
/obj/machinery/door/firedoor/border_only{
	dir = 4
	},
/obj/effect/spawner/structure/window/shuttle,
/turf/open/floor/plating/airless,
/area/shuttle/escape)
"Ql" = (
/obj/machinery/door/firedoor/border_only{
	dir = 8
	},
/obj/machinery/door/firedoor/border_only{
	dir = 4
	},
/obj/machinery/door/airlock/external{
	name = "Horizon Corporation Shuttle"
	},
/turf/open/floor/plating,
/area/shuttle/escape)
"Qu" = (
/obj/effect/decal/cleanable/dirt,
/turf/open/floor/plating,
/area/shuttle/escape)
"QQ" = (
/obj/structure/window/reinforced,
/obj/machinery/computer/secure_data/laptop{
	dir = 1;
	pixel_y = 4
	},
/obj/structure/table/reinforced,
/obj/machinery/door/firedoor/border_only,
/turf/open/floor/mineral/plastitanium/red,
/area/shuttle/escape)
"QW" = (
/obj/machinery/vending/medical,
/obj/machinery/light,
/turf/open/floor/mineral/titanium,
/area/shuttle/escape)
"QX" = (
/turf/open/floor/mineral/titanium/white,
/area/shuttle/escape)
"Rf" = (
/obj/effect/spawner/structure/window/shuttle,
/obj/machinery/door/firedoor/border_only{
	dir = 8
	},
/turf/open/floor/plating/airless,
/area/shuttle/escape)
"Rl" = (
/obj/machinery/vending/wallmed{
	name = "Emergency NanoMed";
	use_power = 0
	},
/turf/closed/wall/mineral/titanium,
/area/shuttle/escape)
"RV" = (
/obj/machinery/computer/arcade/minesweeper,
/turf/open/floor/mineral/titanium,
/area/shuttle/escape)
"Sc" = (
/obj/structure/table,
/obj/item/storage/lockbox,
/turf/open/floor/mineral/titanium/blue,
/area/shuttle/escape)
"Tf" = (
/obj/structure/shuttle/engine/heater{
	dir = 1
	},
/obj/structure/window/plasma/reinforced,
/turf/open/floor/plating/airless,
/area/shuttle/escape)
"Uw" = (
/turf/open/floor/plating,
/area/shuttle/escape)
"Uz" = (
/obj/structure/chair/comfy/shuttle{
	dir = 4
	},
/obj/machinery/door/firedoor/border_only,
/turf/open/floor/mineral/titanium,
/area/shuttle/escape)
"UE" = (
/obj/structure/chair/comfy/shuttle{
	dir = 8
	},
/obj/structure/window/reinforced{
	dir = 4
	},
/obj/machinery/door/firedoor/border_only{
	dir = 1
	},
/turf/open/floor/mineral/titanium,
/area/shuttle/escape)
"Vk" = (
/obj/machinery/light{
	dir = 4
	},
/obj/structure/chair/comfy/shuttle{
	dir = 8
	},
/turf/open/floor/mineral/titanium,
/area/shuttle/escape)
"VU" = (
/obj/machinery/door/firedoor/border_only,
/obj/machinery/door/firedoor/border_only{
	dir = 1
	},
/obj/machinery/door/airlock/public,
/turf/open/floor/mineral/titanium,
/area/shuttle/escape)
"WT" = (
/obj/item/storage/box/drinkingglasses,
/obj/item/reagent_containers/food/drinks/bottle/lizardwine,
/obj/effect/turf_decal/tile/bar{
	dir = 1
	},
/obj/effect/turf_decal/tile/bar,
/obj/structure/table,
/turf/open/floor/plasteel,
/area/crew_quarters/kitchen)
"XA" = (
/obj/machinery/defibrillator_mount/loaded{
	pixel_x = -28;
	pixel_y = -3
	},
/turf/open/floor/mineral/titanium/white,
/area/shuttle/escape)
"XZ" = (
/obj/machinery/computer/station_alert{
	dir = 8
	},
/turf/open/floor/mineral/titanium/blue,
/area/shuttle/escape)
"Yn" = (
/obj/machinery/computer/emergency_shuttle{
	dir = 1
	},
/turf/open/floor/mineral/titanium/blue,
/area/shuttle/escape)
"Zg" = (
/obj/structure/toilet,
/obj/machinery/light/small{
	dir = 1
	},
/turf/open/floor/mineral/titanium,
/area/shuttle/escape)

(1,1,1) = {"
BA
BA
BA
BA
BA
BA
BA
BA
BA
BA
BA
BA
BA
BA
BA
BA
BA
BA
BA
BA
BA
Cc
BA
BA
BA
BA
BA
BA
BA
BA
BA
BA
BA
cz
cz
cz
cz
cz
cz
cz
"}
(2,1,1) = {"
Pe
Tf
hu
hu
hu
nI
dn
dn
BA
dn
dn
dn
dn
BA
my
my
my
BA
dn
dn
Uz
hu
BA
mC
Uw
cM
BA
Lg
WT
Nw
sO
aZ
BA
BA
cz
cz
cz
cz
cz
cz
"}
(3,1,1) = {"
Pe
Tf
DY
hu
hu
dy
hu
hu
jH
hu
hu
hu
hu
Ff
hu
hu
hu
Ff
hu
hu
bF
hu
BA
xH
Uw
Qu
BA
lg
Hb
Hb
Hb
Hb
Hb
BA
BA
cz
cz
cz
cz
cz
"}
(4,1,1) = {"
Pe
Tf
DY
hu
hu
UE
Cf
Cf
BA
qd
Cf
Cf
Cf
BA
xl
hu
QW
BA
qd
Cf
kK
hu
BA
BA
Ql
BA
BA
BA
ui
Mp
fk
jB
Mp
Iy
BA
BA
cz
cz
cz
cz
"}
(5,1,1) = {"
BA
BA
DY
hu
hu
do
sN
sN
BA
AS
sN
sN
sN
BA
xl
hu
QW
BA
AS
sN
xb
hu
BA
Iv
hu
Iv
jF
Uz
hu
Ip
Ip
Ip
Ip
OJ
dC
BA
BA
cz
cz
cz
"}
(6,1,1) = {"
cz
BA
DY
hu
hu
dy
hu
hu
jH
hu
hu
hu
hu
Ff
hu
hu
hu
Ff
hu
hu
bF
hu
Fi
hu
hu
hu
hu
bF
hu
hu
hu
hu
hu
hu
Mc
BA
BA
BA
BA
BA
"}
(7,1,1) = {"
cz
vO
hu
hu
hu
OD
Bp
Bp
BA
Bp
Bp
Bp
Bp
BA
NN
NN
NN
BA
Bp
Bp
JU
hu
BA
Cf
hu
tA
Cf
kK
hu
xp
yZ
yc
Ce
hu
yo
BA
zP
id
Sc
ja
"}
(8,1,1) = {"
cz
BA
Jz
hu
hu
BA
BA
BA
BA
BA
pX
pX
BA
BA
Rf
pX
pX
BA
BA
BA
BA
hu
BA
xZ
hu
MV
sN
xb
hu
Is
Br
xN
QQ
hu
hu
BA
CQ
DY
ze
ja
"}
(9,1,1) = {"
cz
BA
vR
hu
hu
Nx
GB
aD
BA
Oh
Oh
Oh
Oh
BA
Oh
Oh
Oh
BA
Zg
GB
VU
hu
BA
jA
hu
hu
hu
bF
Ii
BA
BA
BA
Rl
hu
hu
gm
hu
si
Yn
ja
"}
(10,1,1) = {"
cz
BA
Jz
hu
hu
BA
BA
BA
BA
BA
PX
PX
BA
BA
PX
PX
PX
BA
BA
BA
BA
hu
BA
nQ
hu
tA
Cf
kK
hu
QX
XA
QX
QX
hu
hu
BA
Dj
DY
FW
ja
"}
(11,1,1) = {"
cz
vO
hu
hu
hu
nI
dn
dn
BA
dn
dn
dn
dn
BA
dn
dn
dn
BA
dn
dn
Uz
hu
BA
sN
hu
MV
sN
xb
hu
QX
QX
QX
QX
hu
yo
BA
XZ
mJ
Cm
ja
"}
(12,1,1) = {"
cz
BA
DY
hu
hu
dy
hu
hu
jH
hu
hu
hu
hu
yj
hu
hu
hu
jH
hu
hu
bF
hu
Fi
hu
hu
hu
hu
bF
hu
pn
Mg
RV
hu
hu
hu
BA
BA
BA
BA
BA
"}
(13,1,1) = {"
BA
BA
DY
hu
hu
UE
Cf
Cf
BA
qd
Cf
Cf
Cf
BA
qd
Cf
Cf
BA
qd
Cf
kK
hu
BA
Vk
hu
Vk
er
JU
BA
BA
BA
BA
yB
eN
sB
BA
BA
cz
cz
cz
"}
(14,1,1) = {"
ih
Tf
DY
hu
hu
do
sN
sN
BA
AS
sN
sN
sN
BA
AS
sN
sN
BA
AS
sN
xb
hu
BA
BA
DV
BA
BA
BA
CM
qb
OC
Nd
kE
BA
BA
BA
cz
cz
cz
cz
"}
(15,1,1) = {"
ih
Tf
DY
hu
hu
dy
hu
hu
jH
hu
hu
hu
hu
yj
hu
hu
hu
jH
hu
hu
bF
hu
BA
bZ
Uw
Qu
BA
oo
QX
QX
QX
kE
kE
BA
BA
cz
cz
cz
cz
cz
"}
(16,1,1) = {"
ih
Tf
hu
hu
hu
OD
Bp
Bp
BA
Bp
Bp
Bp
Bp
BA
Bp
Bp
Bp
BA
Bp
Bp
JU
hu
BA
CR
Uw
cM
BA
qV
Hu
vd
st
Ka
BA
BA
cz
cz
cz
cz
cz
cz
"}
(17,1,1) = {"
BA
BA
BA
BA
BA
BA
BA
BA
BA
BA
BA
BA
BA
BA
BA
BA
BA
BA
BA
BA
BA
BA
BA
BA
BA
BA
BA
LF
LF
Hp
Hp
Hp
BA
cz
cz
cz
cz
cz
cz
cz
"}
